11 10
...31.....
.33.......
.32.....2.
.........2
....2.....
1......1..
..........
..11......
..11.11.1.
.2.......1
....1..E..
