6 9
....11..1
1.....E.1
..111....
.1.......
.....111.
1.......1
