13 13
......1...1..
.2.........1.
1......1....1
1.....E....1.
1....2.3.....
........2....
..1.11.2.....
............4
.....1.....1.
..1.......1..
..432.......2
.............
......1..3.3.
