9 9
....1....
..11.111.
.1.....1.
.1.....1.
1...E...1
.1.....1.
.1.....1.
.111.11..
....1....
