13 10
..2.......
.....2....
...E....1.
.1.....1..
.........3
..........
3..2.....3
..........
4.........
....33..1.
....2.....
..5...14.5
.....2....
