10 10
..4......5
..........
..........
....1.....
......2...
........7.
2..E......
.......1.2
..........
5.2..3....
