8 8
..2.....
.......4
2.....1.
...1....
....E...
4.......
3.......
....1...
