8 8
...2...E
........
..3.....
4......2
........
.....11.
......1.
....2...
