10 10
..4.......
..........
..........
....1.....
......2...
......4...
2..E......
.........4
..........
.....3....
