5 8
....E...
2.......
.......2
.11111..
.1....1.
