7 8
..2...1.
1...E.1.
..1....1
.2......
.1..1...
......3.
...1.1..
