7 9
..3......
....1....
.....11..
1..E....1
.....11..
....1....
.2.......
