7 10
....2.....
.2........
.1.....1.1
31......1.
..1.......
...E.1....
.....2....
