7 8
.....1..
3.......
.......5
1...1.E.
..3.....
...2....
.2......
