8 8
....1...
..11.111
.1.....1
.1.....1
1...E..1
.1......
.1......
.1111...
