8 8
.....2..
..E.1...
.......2
.......3
........
.12.....
3.......
...23...
