6 9
...2.1...
.....2...
........3
1...E...1
..1....1.
....1....
