12 11
...33......
...........
.2.........
......1..3.
...........
.E.1.......
3....1.....
.....1.....
..1....1..3
.1.........
........3..
....2..1...
