9 9
....3....
...2..2..
.E...1...
........2
......4..
........2
.2.1.11..
2.1......
...1.....
