8 10
......1...
....E.1...
2......1..
....1....3
.1........
....1.....
..4...2...
...1.1....
