9 9
....1....
..1......
...1...3.
4..1.....
....11...
...1....E
...1.....
......1..
........2
