11 10
...3......
.31.......
.13.......
..........
....2.....
1.........
..........
..11......
..11.11...
.2........
....1..E..
