7 9
.2..1....
........5
.........
1...E...1
2.......1
....1..3.
...1...2.
