12 8
..2.....
...1....
......4.
..4.4...
.......3
.2......
........
........
...1...E
4.......
........
.......2
