14 13
..2..........
..........6..
.............
.........6...
4............
4.......E....
....4........
.............
.......6....5
.............
.............
.......1....5
.............
.....6..4....
