9 9
.5...4...
.........
.......41
..2....5.
.......3.
.......11
..E......
2........
...12....
