9 9
...1..2..
.2.......
....1....
......1.E
..2......
..1......
123....11
..1..2...
...23....
