7 13
...3...11..1.
.1..11.11.1..
.1..........1
..1...1..1...
1.....1..1...
....1........
..E..........
