9 9
.....2...
.E......1
..1.1....
......1..
11.2...1.
..1.....1
...1....2
..1...1..
....3....
