12 12
.1..........
..11........
..11....1...
1...1.......
......11....
......11....
.1......1...
............
1.E......11.
...111...11.
...........2
.11..11.....
