10 13
.........2...
..1..........
....11.11....
....11.11....
....11......1
....11....11.
1.....3...11.
.11..........
.11......E...
...1.........
