11 9
......1..
.2.......
........1
..1...E..
.21.....1
.12.....1
.12...1..
1........
1........
3........
...111.4.
