8 12
E.....1.....
..1.....111.
1......2...3
.......1....
.......1...3
.2..1...213.
.....1......
...21.......
