9 13
........3....
...........1.
..2...22....1
....1....1..1
.........1..1
1.........1..
.1..E..1.....
.1.....3.....
...4.........
