11 10
.......3..
..........
.11.1.....
....1....2
2....1....
........1.
1....E...1
......2...
....2.....
2.1.......
.3.4......
