11 11
.......121.
.2...1.....
....1.....1
.....2.....
....2.....1
...1....E..
..31......1
2..........
......2....
...1....13.
..2........
