12 10
..111.11..
2.........
..2..1....
.....11...
.....1....
.....11...
2......E..
.3........
....1.....
.........1
.2111111..
........1.
