13 10
.......2..
....2.....
.2....E...
........1.
3.........
..........
2.....2..3
..........
........3.
.1..33.3..
.....2....
2.41......
....2.....
