14 12
..........2.
.......3....
............
..........1.
....4.......
...2.......1
.....E....2.
..2.........
.......1....
3..........3
........11..
..1.2...11..
.2........2.
.....3......
