9 11
......111..
...21...1..
....11..1..
....2..2.2.
3.1......13
..........1
.11........
....1......
.E.........
