13 11
....2..2...
...25.2....
........1..
.......3...
.......1...
.......2...
.....E.....
.2......11.
.3......11.
.1........2
.2.........
1....1.....
..3........
