14 11
.......4...
...3.......
...........
3..........
....2...121
..........3
.1.1......2
.1.1......1
.1.1.......
..1.1......
.......E.1.
4..........
.....2.....
.......1...
