10 10
.3.1......
......1...
..1.111...
..1.......
....1.2..3
1....E..1.
..........
...11.....
......11..
..2..1....
