14 11
..........1
..1...3....
1.........E
.1.....1...
11.1111....
.1........1
.1.........
.1.....1..1
.1.........
11.1111....
.1.....1...
1..........
..1......1.
..........1
