11 12
...1........
..1.1.......
......1..2..
.2..........
1...........
1...2222..2.
....2..4....
.1..3..2....
....2532...1
..1........1
.........E..
