13 11
.......3...
...........
...2....1..
.1....1....
4.21......3
1.........2
.......3..1
....1......
.........1.
..E......1.
......11...
.....3...2.
..1.....3..
