5
50 50
--------------**********************--------------
--------------**********************--------------
--------------**--**--**--**--**--**--------------
--------------**--**--**--**--**--**--------------
--------------**--**--**--**--**--**--------------
--------------**--**--**--**--**--**--------------
--------------**11**11**11**11**11**--------------
--------------**11**11**11**11**11**--------------
--------------**--**--**--**--**--**--------------
--------------**--**--**--**--**--**--------------
--------------**--**--**--**--**--**--------------
--------------**--**--**--**--**--**--------------
--------------**********************--------------
--------------**********************--------------
**************----------**----------**************
**************----------**----------**************
**----11----**----------**----------**----11----**
**----11----**----------**----------**----11----**
**************----------**----------**************
**************----------**----------**************
**----11----**----------**----------**----11----**
**----11----**----------**----------**----11----**
**************----------**----------**************
**************----------**----------**************
**----11----**************************----11----**
**----11----**************************----11----**
**************----------**----------**************
**************----------**----------**************
**----11----**----------**----------**----11----**
**----11----**----------**----------**----11----**
**************----------**----------**************
**************----------**----------**************
**----11----**----------**----------**----11----**
**----11----**----------**----------**----11----**
**************----------**----------**************
**************----------**----------**************
--------------**********************--------------
--------------**********************--------------
--------------**--**--**--**--**--**--------------
--------------**--**--**--**--**--**--------------
--------------**--**--**--**--**--**--------------
--------------**--**--**--**--**--**--------------
--------------**11**11**11**11**11**--------------
--------------**11**11**11**11**11**--------------
--------------**--**--**--**--**--**--------------
--------------**--**--**--**--**--**--------------
--------------**--**--**--**--**--**--------------
--------------**--**--**--**--**--**--------------
--------------**********************--------------
--------------**********************--------------
50 50
--------------**********************--------------
--------------**********************--------------
--------------**--**--**--**--**--**--------------
--------------**--**--**--**--**--**--------------
--------------**--**--**--**--**--**--------------
--------------**--**--**--**--**--**--------------
--------------**00**00**00**00**00**--------------
--------------**00**00**00**00**00**--------------
--------------**--**--**--**--**--**--------------
--------------**--**--**--**--**--**--------------
--------------**--**--**--**--**--**--------------
--------------**--**--**--**--**--**--------------
--------------**********************--------------
--------------**********************--------------
**************----44----**----11----**************
**************----44----**----11----**************
**----00----**----44----**----11----**----00----**
**----00----**----44----**----11----**----00----**
**************4444444444**1111111111**************
**************4444444444**1111111111**************
**----00----**----44----**----11----**----00----**
**----00----**----44----**----11----**----00----**
**************----44----**----11----**************
**************----44----**----11----**************
**----00----**************************----00----**
**----00----**************************----00----**
**************----33----**----22----**************
**************----33----**----22----**************
**----00----**----33----**----22----**----00----**
**----00----**----33----**----22----**----00----**
**************3333333333**2222222222**************
**************3333333333**2222222222**************
**----00----**----33----**----22----**----00----**
**----00----**----33----**----22----**----00----**
**************----33----**----22----**************
**************----33----**----22----**************
--------------**********************--------------
--------------**********************--------------
--------------**--**--**--**--**--**--------------
--------------**--**--**--**--**--**--------------
--------------**--**--**--**--**--**--------------
--------------**--**--**--**--**--**--------------
--------------**00**00**00**00**00**--------------
--------------**00**00**00**00**00**--------------
--------------**--**--**--**--**--**--------------
--------------**--**--**--**--**--**--------------
--------------**--**--**--**--**--**--------------
--------------**--**--**--**--**--**--------------
--------------**********************--------------
--------------**********************--------------
50 50
--------------**********************--------------
--------------**********************--------------
--------------**--**--**--**--**--**--------------
--------------**--**--**--**--**--**--------------
--------------**--**--**--**--**--**--------------
--------------**--**--**--**--**--**--------------
------**********00**00**00**00**00**********------
------**********00**00**00**00**00**********------
------**------**--**--**--**--**--**------**------
------**------**--**--**--**--**--**------**------
------**------**--**--**--**--**--**------**------
------**------**--**--**--**--**--**------**------
------**------**********************------**------
------**------**********************------**------
**************----------------------**************
**************----------------------**************
**----00----**----------------------**----00----**
**----00----**----------------------**----00----**
**************----------------------**************
**************----------------------**************
**----00----**----------------------**----00----**
**----00----**----------------------**----00----**
**************----------------------**************
**************----------------------**************
**----00----**----------------------**----00----**
**----00----**----------------------**----00----**
**************----------------------**************
**************----------------------**************
**----00----**----------------------**----00----**
**----00----**----------------------**----00----**
**************----------------------**************
**************----------------------**************
**----00----**----------------------**----00----**
**----00----**----------------------**----00----**
**************----------------------**************
**************----------------------**************
------**------**********************------11----22
------**------**********************------11----22
------**------**--**--**--**--**--**------11----22
------**------**--**--**--**--**--**------11----22
------**------**--**--**--**--**--**------11----22
------**------**--**--**--**--**--**------11----22
------**********00**00**00**00**00**11111111----22
------**********00**00**00**00**00**11111111----22
--------------**--**--**--**--**--**------------22
--------------**--**--**--**--**--**------------22
--------------**--**--**--**--**--**------------22
--------------**--**--**--**--**--**------------22
--------------**********************22222222222222
--------------**********************22222222222222
50 50
********************----------********************
********************----------********************
**----------------**----------**----------------**
**----------------**----------**----------------**
********************----------********************
********************----------********************
**----------------**----------**----------------**
**----------------**----------**----------------**
********************----------********************
********************----------********************
**----------------**----------**----------------**
**----------------**----------**----------------**
********************----------********************
********************----------********************
**----------------**----------**----------------**
**----------------**----------**----------------**
**************************----********************
**************************----********************
------------------------**----**------------------
------------------------**----**------------------
------------------------**----**------------------
------------------------**----**------------------
------------------------**----**------------------
------------------------**----**------------------
------------------**************------------------
------------------**************------------------
------------------**----**------------------------
------------------**----**------------------------
------------------**----**------------------------
------------------**----**------------------------
------------------**----**------------------------
------------------**----**------------------------
********************----**************************
********************----**************************
**----------------**----------**----------------**
**----------------**----------**----------------**
********************----------********************
********************----------********************
**----------------**----------**----------------**
**----------------**----------**----------------**
********************----------********************
********************----------********************
**----------------**----------**----------------**
**----------------**----------**----------------**
********************----------********************
********************----------********************
**----------------**----------**----------------**
**----------------**----------**----------------**
********************----------********************
********************----------********************
50 50
**************************************************
*11111111111111111111111**11111111111111111111111*
*1----------------------**----------------------1*
*1----------------------**----------------------1*
*1----------------------**----------------------1*
*1----------------------**----------------------1*
*1----------------------**----------------------1*
*1----------------------**----------------------1*
*1----------------------**----------------------1*
*1----------------------**----------------------1*
*1----------------------**----------------------1*
*1----------------------**----------------------1*
*1----------**************************----------1*
*1----------**************************----------1*
*1----------**--44--**--55--**--44--**----------1*
*1----------**--44--**--55--**--44--**----------1*
*1----------**************************----------1*
*1----------**************************----------1*
*1----------**--33--33--33--33--33--**----------1*
*1----------**--33--33--33--33--33--**----------1*
*1----------**************************----------1*
*1----------**************************----------1*
*1----------**--44--**--55--**--44--**----------1*
*1----------**--44--**--55--**--44--**----------1*
**************************************************
**************************************************
*1----------**--44--**--55--**--44--**----------1*
*1----------**--44--**--55--**--44--**----------1*
*1----------**************************----------1*
*1----------**************************----------1*
*1----------**--22--22--22--22--22--**----------1*
*1----------**--22--22--22--22--22--**----------1*
*1----------**************************----------1*
*1----------**************************----------1*
*1----------**--44--**--55--**--44--**----------1*
*1----------**--44--**--55--**--44--**----------1*
*1----------**************************----------1*
*1----------**************************----------1*
*1----------------------**----------------------1*
*1----------------------**----------------------1*
*1----------------------**----------------------1*
*1----------------------**----------------------1*
*1----------------------**----------------------1*
*1----------------------**----------------------1*
*1----------------------**----------------------1*
*1----------------------**----------------------1*
*1----------------------**----------------------1*
*1----------------------**----------------------1*
*11111111111111111111111**11111111111111111111111*
**************************************************
